3 20 20
2 0
1 0
0 0
CCCCCCCCCCCCCCCCCCCC
CCCCCCCCCCCCCCCCCCCC
CCCCCCCCCCCCCCCCCCCC
CCCCCCCCCCCCCCCCCCCC
CCCCCCCCCCCCCCCCCCCC
CCCCCCCCCCCCCCCCCCCC
CCCCCCCCCCCCCCCCCCCC
CCCCCCCCCCCCCCCCCCCC
CCCCCCCCCCCCCCCCCCCC
CCCCCCCCCCCCCCCCCCCC
CCCCCCCCCCCCCCCCCCCC
CCCCCCCCCCCCCCCCCCCC
CCCCCCCCCCPCCCCCCCCV
CCCCCCCCCTTTTCCCCCCC
CCCCCCCCCTTTTCCCCCCC
TTTTTTTTTTTTTTTTTTTT
TTTTTTTTTTTTTTTTTTTT
TTTTTTTTTTTTTTTTTTTT
TTTTTTTTTTTTTTTTTTTT
TTTTTTTTTTTTTTTTTTTT